,,,,,,,,,,,,,,,,,,,,,,,,,,
,,,,,,,,,,,,,,,,,,,,,,,,,,
,,0,0,0,0,0,0,1,1,1,1,1,0,0,0,0,0,0,0,0,0,0,0,0,0,0
,,0,0,0,0,0,0,1,1,1,1,1,0,0,0,0,0,0,0,0,0,0,0,0,0,0
,,0,0,0,0,0,0,1,1,1,1,1,0,0,0,0,0,0,0,0,0,0,1,1,1,0
,,0,0,0,0,0,0,0,2,2,2,1,0,0,1,1,0,0,0,0,0,0,1,1,1,0
,,1,1,1,1,1,0,0,0,3,3,0,0,0,1,1,1,0,0,0,0,0,1,1,1,0
,,1,1,1,1,1,0,0,0,0,0,0,0,0,2,1,1,0,0,0,0,0,0,2,2,0
,,1,1,1,1,1,0,0,0,0,0,0,0,0,3,2,2,0,1,1,1,1,0,0,3,0
,,0,2,2,2,1,0,0,0,0,0,0,0,0,0,3,3,0,1,1,1,1,0,0,0,0
,,0,0,3,3,0,0,0,0,0,0,0,0,0,0,0,0,0,1,1,1,1,0,0,0,0
,,0,0,0,0,0,0,0,0,0,0,0,0,0,0,0,0,0,0,2,2,2,0,0,0,0
,,0,0,0,0,0,0,0,0,0,0,0,0,0,0,0,0,0,0,0,3,3,0,0,0,0
,,0,0,0,0,0,0,0,0,0,0,0,0,0,0,0,0,0,0,0,0,0,0,0,0,0
,,0,0,0,0,0,0,0,0,0,0,0,0,0,0,0,0,0,0,0,0,0,0,0,0,0
,,13,13,13,13,13,13,13,13,14,14,14,14,14,14,14,14,14,14,15,15,15,15,15,15,15